message	predicted
Bars nearby	nearby
I wish to gift my girlfriend a gift on her birthday can u suggest some ideas	shopping
Smart tv	shopping
Can you check the time of shalimar express from delhi	travel
today multiplex me days of tafree ka details	travel
And return policy	travel
Where is awadassam exp train no 15910	travel
I want to buy a some books	travel
New Udupi restaurant menu	food
Garib rath ratlam to boriwali today 3tier seat availability	travel
See MI 3s cover	shopping
Suraj cinema najafgarh which movie today	movies
Tell me the trains from Delhi to Koderma	travel
Egg biryani	food
Reliance store near my location	nearby
Cancel my all wake up alarm	reminders
10 th	travel
Hey can you give me some details on McDonald's like menu,opening closing time	food
Hi can u show me second seater tickets for intercity on Sunday morning	travel
Please send me world trade park jaipur mall pic	travel
Please turn off these reminders	reminders
SBSTC TIMING FROM ASANSOL TO KOLKATA	travel
after every 30 min	reminders
Bathroom cleaner	shopping
OK , Can you please book the technician for me.	travel
I want to know near by reliance jio mini stores	nearby
Womens shoes for my mom size 10  Rs 4000 to 5000	shopping
not able to recharge121 on aircel	recharge
Any medical store near my location	nearby
Pens without cartridge refils	travel
I want Peter England white shirt for men	shopping
Adidas superstar shoe price in india	shopping
Samsung mobile service centre in pimple saudagar	shopping
Cncl dh reminder	reminders
Can I get jacket   or sweater	shopping
Is there an unlimited data pack?	recharge
Men's sandals	shopping
What's the fare of Hyderabad to Mumbai in flight	travel
i want to know... Railway Ticket Charge for. .  kannur to Alleppey . .  Sleeping compartment	travel
Can't you remind me the context of the reminder	reminders
Order something	food
Can i  get train details	travel
Train available today from Delhi to Allahabad	travel
Suggest me some gift for male best friend	shopping
32. GB 3.0 dual USB pendrive	shopping
Find me the cheapest air ticket to Mumbai	travel
I want to book two tickets of 10:45 . Royal	travel
I want a wakeup call at 6:41 every day except sunday	reminders
Kfc menu pls	food
side row	travel
Kutch	travel
What should be the cheapest 3nights plan for Goa	travel
I want to buy Amazon E-Gift Card{carousel_cta}	shopping
trimmer	shopping
Plz remind me on every Monday nd Thursday I hv to msg one doctors	reminders
Where do I find the most spicy non veg Biriyani in Hyderabad?	food
Kindly remind me on10.30 am to call mr sandha babu.	reminders
Hey get me the fare for howrah rajdhani	travel
Check the cheapest  lowest fair price for air plane ticket Jaipur to Mumbai from goibibo	travel
Now u can stop this reminder	reminders
I want recipe of chiken chilly	food
Sbi	travel
Mi 3s prime show me plz	shopping
Opticals nearby	nearby
Is there train from ooty to Bangalore. Today and tom	travel
You place the order?	food
I want to go to Delhi, mathura,vrindavan,dwarka, rishikesh haridwar please make a proper plan for my trip	travel
Please remind me to pay mobile bill on next Saturday at 9pm	reminders
Don't want wake up call	reminders
Tell me the train between Boisar to Surat	travel
Car service	support
Price k5 plus lenovo	shopping
I want to buy a scooter	travel
What About train train on 16th late night	travel
I wanted to plan a trip to north during this Diwali	travel
Gorakhpur to delhi	travel
17416 train right time	travel
I want evening train details	travel
Any train which the seats are available	travel
S case grip back cover I like it	shopping
Shoes store near hatibagan	shopping
Can u delete the remainder kept on 19-10-2016	reminders
Banks nearby?	nearby
Is there a vacancy in a sleeper class ?	travel
New Delhi to Patna	travel
Hey am in siliguri, looking for shopping for men specially pant, (jeans)  casual shoe and jumper .	shopping
Call Kashif at 11 am today for wish Eid	reminders
Hey I would like to order one veg singles combo from dominos!	food
I lyk the blue	shopping
I want to buy micromax mega 2 Q426	shopping
And for table booking	travel
Hi, Can you help me book train tickets?	travel
Set a reminder today 12 noon . Plz	reminders
Suggest me good hotels in mumbai	travel
I need SBI ATM	travel
from where i can buy it	travel
Could u help me with flight fares from hyderabad to ahmedabad during diwali	travel
Please send train schedule of bhavnagar	travel
I want to know the offers on recharge, bill payment of airtel prepaid and postpaid	recharge
Sonu	travel
There's a restaurant in vashi. Four points	food
tesihon movie timing in pwelian cinema ldh	movies
I want train between vasai road to lonavala today	travel
3bhk	travel
Jantha garage benifit shows in hyderabad	travel
I don't specifically want those features I want a laptop of 2.5 or greater speed processor and greater than 8 GB ram	shopping
Domino's offer	food
honda service center	support
Why u refund my money?	recharge
Need bar menu's for Ten down street nagpur	food
Near by pvr cinema	movies
I need to order 5 chocochip and 1 Vailine ice cream from Cafe Dlite Goregoan	food
Not airtel	recharge
Hey plz help me with the platform no on which train 12630 will arrive in Hubli	travel
Can you find out any Chinese restaurant in Hyderabad	food
Is there any restro lounge here	food
Do u have any antik iPhone 6splus cover	shopping
Just now I again received order cancelled message from flipkart	shopping
Nashra can u send me today night Bangalore yeshwanthopore train from calicut	travel
just show me the key chains	shopping
Can ew check the train status	travel
What will the cost of 1 wig for men	travel
Find me nearest hdfc atm	nearby
Cancel the reminder	reminders
Any cheaper flight on 18	travel
Which is the best restaurant in mumbai panvel	travel
Row above that...E row	travel
I want to buy fourth year BDS books	travel
Delhi to akola 20 septe	travel
Can u wake me up at 6 in the morning pls	reminders
sir balance nhi refund hua mera.....	recharge
Can u plz tellme where's union bank in vasai west	nearby
Best noodles	shopping
Women's clothes	shopping
Morena to nzm taj express which platform no. Is coming	travel
Can you plz check for this PNR ? Baggage allowance	travel
trip to shimla	travel
Dinner for one budget upto rs. 100. Can u book for home delivery?	food
pls tell me about yes bank atm	nearby
Is there any hotel for stay?	travel
Need a taxi	travel
SanDisk Ultra 16 GB MicroSDHC Class 10 48 MB/s Memory Card is available fpr Rs. 298 after a discount of 25% off	shopping
Good gujarati restaurant	food
Yes bank	nearby
Is there any cash back offers for recharge	recharge
16 GB pen drive is buying	shopping
Camcel all reminders	reminders
idbi bank	nearby
still getting massage and call	reminders
Specs frame	shopping
Any offers to travel to delhi on 23 .9 .16 back to hyd on 25.9.16	travel
What the show timings in gayathri theatre in tumkur	movies
Cinepolis kochi runnig movies ?	movies
What time is the afternoon show at Gayatri theatre Mysore	travel
Indore to Goa flight for 2	travel
Could you please set a reminder	reminders
I want to buy this tshrt for couple	travel
delhi to mcleodganj please plan a two day trip for me	travel
Ranchi to daltenganj  by ac bus in morning on 27.09.16	travel
Nearest music store	nearby
timing of south indian food in kasba	food
I want to buy Funky Ankle socks Combo 1{product_id:3437, product_name:Funky Ankle socks Combo 1, api_id:, api_name:deal_of_day}{carousel_cta}	shopping
Aerobics classes near by arena mall	travel
refund naya	travel
I need to go to nearest hill station from Delhi	travel
October 4	travel
Hey I am Looking For Some Bluetooth earphones	shopping
I need jbl earphones	shopping
Pune to patna jana h 17.3.2017 Ko flight	travel
activate DND	reminders
Can u check me ticket from chennai to hubli tomorrow	travel
Please find me nearest post office	nearby
The recharge was not successful	recharge
No I took this train 5.15 pm in evening	travel
Check  seat available in any train	travel
Hi, show me best deals on mobile phones{task}	shopping
Two ticket	travel
Remind me that i have to go to bank tomoro	reminders
Find me a cheap hotel in Bikaner, Rajasthan close to BSF Camp, Sagar Road. A room for two.	travel
Please make sure that I wake up	reminders
Hey, can you remind me about i am to take payment from sonu kumar on 5th of October	reminders
Plz tell me about low prize cost flight tikit before 3month	travel
Can you check flights for Delhi Kolkata for tomorrow	travel
Ram	travel
Any cheapest food	food
Good but I am not satisfied ... OK I will send u some pictures of t-shirts , nd I hope u will understand, nd u show those types of t-shirts... For me.	shopping
Wish to know detailed features of iPhone 7	shopping
Dominos cupon valid today?	food
Redmi 3s prime has different sim slot or same for memory card ?	shopping
Can you show some malayalam movies	movies
Hey, find me nearest Indulsnd bank branch	nearby
iwant to go to ananthapur from vellore tomorrow  by bus	travel
If I Catch train  Kamrup from Kishangunge, What time I reach Malda	travel
McDonald's coupons please	food
Mumbai local train map was not dowloade	travel
17 Sep chennai to Hyderabad trains	travel
Drop reminder	reminders
Nearby dance class	nearby
Ya that red one	travel
Hey, can you set a wake up alarm for me?	reminders
Rental room	travel
Recharge  reminder for tomorrow	reminders
Suggest Wireless mouse	shopping
Wireless key board upto 500 rs	shopping
T-shirt	shopping
Golden thin strap	shopping
I wanted some discount on ola or under ride	travel
Can I travel in train if tickets booked is in waiting list even after chart preparation. Ticket was booked in tatkal quota.	travel
Shopping mall	movies
Stations between Pune and Mumbai Cstm of Deccan Queen 12124	travel
Give me nearest airtel show room to my current location	travel
Can i get pizza	food
Oneplus 3	shopping
Medical shop near me	nearby
What's price  of this movie in pvr sabarmati	movies
How do i switch off a reminder ?	reminders
Can you please check train availability for trains departing from NZM to HPP?	travel
In gold Cinemax santacruz 7 pm show	shopping
I want confirmation ticket for tomorrow	travel
Green seats are available?	travel
Can u msg this number 9714990550 at 12:27	travel
10 liters	travel
Train ticket available in evening from Bangalore to kochi	travel
3star hotel in goa	travel
Thanks for your effort but that train is too late for me ill stay tomorrow night in Delhi and start day after tomorrow	travel
Check my pnr status	travel
Mumbai to dheli	travel
How many kilometers from guruvayoor to palakkad	travel
We found an awesome restaurant on the way	food
Asian sridevi mall	movies
2 Mysore sada dosa w/t cheese, 2 sada dosa, 1 medhu vada.          (tell them to give the red chutney	food
N food court also either restaurant	food
I wanted to buy a table tennis table	food
I want to purchase passion fruit or passion fruit powder	shopping
Best food in vijayawada	travel
Can u book a cab for me?	travel
Can u get me dz type choli	shopping
I have Reliance gsm offer and low call rating recharge	recharge
Vadodara	travel
M planning to visit leh ladakh	travel
Italian restaurant	food
I was looking for a grocery store near me	nearby
M looking for some ethnic stuff	shopping
J7	travel
I need a electrician	support
Any atm of punjab national bank..?	nearby
Ahmedabad to goa bus	travel
Can tell me the price of lenovo laptop with core i5 procrsser, graphic card, 4 gb ram	shopping
Hey i would like to buy 3 litre non stick pressure cooker	shopping
Hi, can you help me find a Shop which sells Car decor items and accessories....nearest to Majiwade petrol station in Thane west.	nearby
party lounge	food
If i want to eat from dominos	food
ATM	travel
I need to book a table at barbe q nation cannaught place Delhi for 8 people	travel
Gentle Reminder!	reminders
I want to have chinese	food
Taxi for me	travel
Book a ticket of train	travel
How is iPhone 7	shopping
remind me to cancel my train tickets at 2.30 pm	travel
Want to book that flight	travel
Solapur to Hyderabad train schedule	travel
Want to by LEd bulbs	travel
Gift for gF	shopping
Wanna buy helmet	shopping
Any wake up alarms active on my number?	reminders
Goa in hotel	travel
I want to buy hair dryer low cost and good quality	shopping
Any cheap holiday packages for Goa in Oct first week?	travel
Ab bje h 8 wt the hell is this i did not get the reminder any time between 8-2	reminders
Hello. Can you show me my reminders	reminders
Subway food	food
I want food  home delivery  near by Jaya engineering college!	food
List all Tamil movies running in Bangalore	movies
Cancel my wake up alarm	reminders
Date if my flight to Mumbai is on 16th October.. I want too change it	travel
Tell me the products with 50%, in jabong	shopping
Bro tel Salem train timing	travel
Which cheapest hotel or lodge in Marathalli Bangalore is available for accommodation today? Let me know immediately	travel
Please check availability in rajdhani express on same day	travel
I need to know about hotels in Ajmer on 31sr October to 1 November with three rooms and 8 persons with breakfast	travel
Kenara bank near sector noida sector 2	nearby
Shoes want	shopping
Train running info for 15658	travel
Which show time tu to gyo gujarati movie in balaji agora mall.	movies
Pls suggest me some trekking bags @ 55 ltr capacity	shopping
Any product related to minions for gifting	shopping
Looking for gym	shopping
Free internet recharge of Vodafone	recharge
I want to book tickets	travel
Hey I want to find out the status of my booking PNR.{task}	travel
Call the traveles	reminders
Wamt to book cab	travel
We have a problem with the pest control we did last	shopping
Which shoes	shopping
Pink movi review	movies
Can you search some flight after 5 in evening	travel
Task: Train Tickets	travel
Can you help me with the bus number if you can iam going to LB nagar and also I need AC bus	travel
Syndicate bank	nearby
pse check lowest flight rates from Dli to jammu on 8 oct 2016 afternoon	travel
I want to by iphone 7 plus 128 gb black	shopping
Madam, I am planning to go Mumbai from Bangalore	travel
Transportation available..??	travel
Plz stop the reminder service	reminders
how to stop reminder	reminders
headphones	shopping
Can you tell me whether it is able to book a hotel for unmarried couple in ludhiana?	travel
Can I order Golden Chana packets?	shopping
Alarm 7.30	reminders
Places to visit in Banglore	travel
Good restaurent	food
Can u find asus service center in cbe	support
Yes I want unlimited safe storage	shopping
Need City Union Bank ATM	nearby
Delhi to Nagpur to Pune	travel
Cuisine or dish: Vada Paav	food
L size	shopping
Is there is 119 full talktime offer	shopping
I want to know the cheapest n shortest way to reach old Delhi railway station to Hazrat nizammudin	travel
How much it will cost if I book 2 tickets at v3s	travel
Show me the socks	shopping
I also put a reminder for tomorrow	reminders
Flight is out of my budget ya	travel
can I recharge my d2h by this	recharge
Mechanic?	travel
You can stop sending reminders,thank you.	reminders
Black colour	shopping
Plz show me in cheap cost	shopping
Need to cooler motor winder	travel
I need a hotel to stay near West Tambaram.	travel
Electrician?	support
Mark a medicine reminder every day of this month 4 p.m	reminders
USA tourist visa agent need in chennai or Ahmedabad but I need best one	travel
Dont cancel my order	reminders
2bhk house on rent	travel
Need t a menu of veg restaurants for evening snacks	food
Adidas sports shoes	shopping
Today 11pm flight price  hyderabad to Goa  one prasn	travel
Show philips brand	shopping
Cancel all my alarms	reminders
Here is any train from ajmer	travel
Pls cancel the water reminders	reminders
Where to get eden garden tickets for ind vs new zealand test match	travel
Got any ola coupons?	travel
Can you share the menu of Shanghai express restaurant near my location?	food
Any offers on food delivery	food
Redmi note 3	shopping
Spa nearby ?	nearby
Any resto open near by	food
Need nearest orphanage address...	nearby
Want to book thane mumbai bus ticket	travel
Please tell about the movies at bathinda	travel
Agaro Mt 5014 trimmer charger	shopping
Thanks but I have ready made shop of cloth so I ve socks for sale	shopping
Any horror movie	movies
Review of flying jet	movies
Hi i want to book an cab	travel
Top ten Robery Hollywood movie	movies
Fastract store near by me	nearby
What abt nigth party for 20 people low cost non-veg with drinks near by viman nagar	food
Manmad Trip	travel
Lucknow to orai train  24/09/2016	travel
I want to buy cr2032 3V battery	shopping
Rajyaraani train live status	travel
I wanna deactivate this reminder	reminders
Any berth preference	travel
Stop the reminder of water	reminders
tell me near by vodafone store	nearby
Tell me abt iphone 7 details	shopping
I want to buy Hariom Enterprises SLF-6528 Selfie Stick  (Multicolor){product_id:3446, product_name:Hariom Enterprises SLF-6528 Selfie Stick  (Multicolor), api_id:, api_name:deal_of_day}{carousel_cta}	shopping
Fare for Bombay to Baroda via Baroda Express for second Sleeper	travel
Hiiiiii..  I shall need the review for the product which you shared in first go from snapdeal	shopping
My cars tyre is punctured.	travel
find a bus for me from bangalore airport to electronics city bangalore.	travel
Hey I don't want u to remind me for water	reminders
Hi can u tell me the train cost for chengalpattu to kadayanallur on October 14 in podhigai expreaa	travel
I want the list of KSRTC bus from kozhikode to ernakulam	travel
I want nearest tourist point in wagholi	travel
DSLR camera upto 32000?	shopping
Hie pooja	travel
XL	travel
Is there any cinema hall in Jajpur,Odisha where I can book the ticket online with less price?	movies
Can u book me a cheapest airfare from Leh to Delhi on 11th of sept	travel
Want to book tickets for baar baar dhekho	travel
Cancel the water reminder	reminders
I am looking for a bag which looks like a sling bag,  which is of large size, that i can take it to college and carry all my books in it	shopping
Set my wake up alarm for every day	reminders
please give me the price of Samsung led 22 inch	shopping
I need a ticket in 2 october from gkp to delhi	travel
Looking for Liquor shop near by	nearby
kolkata guwahati flight fare on 17.10.2016	travel
7 people	travel
Hi.. Can you book tickets for flights if tell you the complete details?	travel
Recipe of chicken chillie	food
I need a ticket to travel Bangalore today	travel
I want to cancel my order	food
Cancel my water remainder	reminders
Pls tell one stop flight to indore from jaipur	travel
Thank u Rakshith. Hw wud I make payment if u book d ticket	travel
Hey i need case for my xiaomi 3s prime	shopping
Set alarm for after 22 minutes	reminders
When will reach bus number 543	travel
iPhone 5s 16 gb what's the best offer	shopping
I need to turn off the remainders	reminders
Till not get my 300 refund	reminders
Malayalam	movies
What will the travel package for a trip to UK in the month of December 2016	travel
Beauty products	shopping
Are seats available in karnavati	travel
Hi can we stop the early morning alarm which u have set for me , about 5 am ?	reminders
Ambala to Bhilwara train any day and route	travel
Lenovo ibe k5 plus	shopping
Car washing machine	shopping
YA glenn temme some non veg restaurant	food
Ma'am... M nt happy with the product quality... I request you to return it	shopping
Can you suggest some travel options for shimla on 25th sept	travel
Travel hand bag	travel
3 k	travel
Best dala plan for Vodafone prepaid	recharge
In rajkot which cinema	travel
Flight ticket from surat to patna	travel
Hi riddhi. I wanted to select my seat on my flight to Mumbai for the day after. Hope you can help me on that.	travel
Find me a travel package to Manali from Amritsar	travel
Can u plz turn off this reminder	reminders
Tomorrow reminder for mock test	reminders
I got my order	food
Pls find a cheapest flight offer for one person oct 2 or 3 2016 ... Timings morning or aftrnoon or evening ..	travel
Can u please look for price of jbl headphones	shopping
I am searching for 40inch TV with exchange offer facility	shopping
12003 train running status	travel
Can u tell my train status	travel
You only sent me my boarding pass, what about anshus boarding pass	travel
Hi i want offers in airtel	recharge
Can you tell train or for Trimbakeshwar from Hyderabad	travel
No other movies?	movies
Sleeper?	travel
Moto g authorised service center	support
Can u book cab for me	travel
Nearby reliance store	nearby
Could u please cancel my 9.20am and 7 pm reminder plz	reminders
Please give me plan for 4 night 5 day in Goa.	travel
From tomorrow onwards	reminders
Shoes?	shopping
Any Telugu movies	movies
Could you get me good Videocon dth recharge offer.....	shopping
Tel me which Tamil movie releasing this weekend	movies
Give me train details from Kolkata to ooty.....I need elaborate details	travel
Pvr vinema	travel
Want to book tickets for the movie pink	movies
Any pizza scheme	food
List of hotels in mysore	travel
I need daily alarm	reminders
Looking for broad strap watch below 150	shopping
The warehouse cafe	food
Hi need to find a Kotak atm near me	nearby
Yes check trains of noght only	travel
Hey what about the money refund	recharge
Give me details about the train of same pnr status	travel
And Boi nearest	nearby
Order a pizza	food
Status please	travel
plz see the availability of seats in shinhagar express (dadar to pune) dated on 25 setp 2016	travel
Plz check availability from guy to siliguri in Rajdhani 1ac	travel
Kindly cancel all my wake up calls scheduled for today!	reminders
How much is ola taking for damab	travel
Pl tell me air india flight timings from delhi to goa	travel
No flights after 2 in the afternoon??	travel
I want to stop all reminders	reminders
In which theatre is this movie	movies
Find me a Vodafone store near Dadar station (E)	nearby
Please call	reminders
Get me recharge coupon codes airtel	recharge
No I want a sbi atm	shopping
Any 3D movies in chennai now	travel
which trains halt there?	travel
Hi i am travelling to tanzania on 27th september i need to know what are all the places to see/visit there	travel
Bar and restaurent	food
Can u please tell me the seat no	travel
I wanted to buy a selfie stick	shopping
Tel me  today's best deals  on mobiles and tvs	shopping
Pappanmcode tvm food available	food
Cheapest deals on stun gun	shopping
Ola coupon for Lucknow	travel
just want to know are the trains workings form Mumbai to ratnagiri?	travel
Please activate dnd on my mobile	reminders
Innar cloth	shopping
Hello can u check train availability for Jalgoun to mumbai on Wednesday night train ?	travel
how about Ksrtc bus status towards Hosur	travel
18509 15.10.2016.sleeper class	travel
I want go nashik to  pune give me  all info  like  bu. Train  and traval  distance	travel
Call me on this number 09718440001	reminders
Size 41	shopping
How far is d airport(Dabolim) from resort ?	travel
Reminder call at 7 am tomorrow	reminders
Can we have current rate of tickets  of movie  pink  wenesday  21/9/2016 inox at Udaipur	movies
I need to travel from Pondicherry to mangalore	travel
After 15 minutes remind me to turn the gas off	reminders
Subway Egmore	travel
Any buses or trains from Kochi to Reissue?	travel
I need breakfast	travel
I need some watch with best deal madam	shopping
Ya send me the menu pls	food
Oppam film vadakumchery theatre name	movies
Can you order jeans from myntra too ?	shopping
I want to order KFC	food
I just want to know that... Is there any local train available From Nagpur to wardha. Before 7am	travel
What movies showing in pondicherry	travel
the cheapest iPhone 7	shopping
Hi what's starting range of Philips trimmer?	shopping
Women condom	shopping
How much it will cost a flight tiket from trivandrum to cochin	travel
Or any tatkal ticket availables	travel
When did i ask for a wake up alarm	reminders
Is it okay to visit Goa in October	travel
Show me some pics of iphone 7	shopping
Vapi to madurai	travel
Origin city ahemadabad	travel
Can u send me coupon codes for ola cabs?	travel
Reilance store near by	nearby
Please do call	reminders
I would like to recharge	shopping
I would like to know the review	shopping
Remind me to contact Tata sky on 09  Oct 2016 at 9 AM	reminders
Can you please confirm the seat? The boarding pass says 3A	travel
Pls set reminder for today 10.30 AM to pay mobile bill	reminders
i want to book an ola cab from my location to pune airport. my ola app is not working	travel
Samsung phone with nano sim	shopping
Brand like red chief	shopping
Tatanagar to new delhi	travel
Its okay .. I'll order some other time	travel
Hp	travel
Hey dear tell me rent between njp to bkn sleeper class adult 12	travel
Send me a text also please as reminder	reminders
Train no 122277	travel
Send me details of iPhone 7	shopping
Are there buses from Mumbai	travel
windows installation error  0x8007025D	travel
Tell me movie timings.?	movies
Any bus right now from himatnagar to Bharuch	travel
Help me to travel to chandigarh from gurgaon	travel
I want to shop shirt	shopping
Thus local buses are runing tommrow	travel
What  is the time of Guwahati to JAGIROAD train	travel
Which account number you gave to snapdeal to refund my amount?	reminders
Nearby jain food restaurant	food
Near	nearby
Cancel my all reminders	reminders
wat r d new apple products launchin	shopping
I want to buy Puma sports sandal	shopping
Please book me a cab	travel
Search me buses that have boarding points near majestic	travel
Remind me to call smita	reminders
How about the exchange policy for the product.? If I have size issues.?	shopping
Hi, please cancel all the reminder from now. Thanks.	reminders
Briyani	travel
goa air ticket in november 20	travel
Remind me the status	reminders
Hi Im looking for car to buy	shopping
Can I exchange my iPhone 6S to buy 7	shopping
California	travel
I want hdfc atm	nearby
can I get soya sauce as home delivery?	food
Can you find me a place in blot for lunch	travel
Thodari review?	movies
Petrol pumps nearby?	nearby
Stop all the reminder alarms	reminders
Dell inspiron 15r lcd screen	shopping
I need good cash back coupon on MTS postpaid bill	recharge
What should i wear in fresher in casual	shopping
Todays show time of banjoo movie of pvr and rama big cinema	movies
Now cancel this reminder	reminders
Yeah. I don't want to miss idly vada tomorrow. So wake me up	reminders
Honeymoon Travel packages for andaman	travel
Sony Xperia customer care toll free number	shopping
Please order a tenda f3 wifi router for me from amazon	shopping
Set me a reminder	reminders
I already got the tickets	travel
Comparison of KTM Duke 200 and KTM duke 390	shopping
The white one, u show me that day	shopping
Nearest sony handycam service center to ruby general hospital ?	nearby
Best gym	shopping
Defence concession	travel
Moja club socks is sports ir casual?	shopping
16525 train timetable	travel
Cancel my water reminder plz...	reminders
I even want call reminder for my dance class	reminders
"Hey, can you find me the nearest ""Naturals"" parlour?"	nearby
Required washing  machine Videocon make semiautomatic repair	shopping
I need  2 innova to be pick us from Goa Airport on 29th September and drop us at North goa at hotel hard rock Cafe. Pls let me know the cost. I will confirm the time later	travel
Set reminders	reminders
Best places to visit on Ahmedabad	travel
i want to make a new reminder	reminders
Send me iPhone 7 picture	shopping
I am looking for HR training professional coaching classes.	nearby
New movies list plz	movies
Remind me to fill the petrol tank tomorrow at 8.30 am.	reminders
Gionee elife s5.5 price	shopping
More details of iphone 7	shopping
Hey, can you connect me with customer care of a company? Airtel dth	support
Is there any scheme of ola cabs or any other for free rides	travel
Adidas superstar shoes	shopping
Indigo luggage limit	travel
Im looking for a headphone under 2000 rs	shopping
Could u get me the running status of train number 12678	travel
How to check reliance prepaid internet balance	recharge
Tell me the best package for Uzbekistan	travel
Lay and ladakh	travel
About iphone 7	shopping
Could you check again for the 4 pm Indigo flight	travel
Hey any offers on dominoes	food
Indigo airlines flight from Mumbai to Goa at 12.15 PM will come at domestic airport or international airport?	travel
Plzz findseat availability	travel
DT city centre mall or grand cinemas	movies
I want to sell my scooty activa	shopping
Airtel service centre in virar west	support
Need a driver for a day	travel
Mumbai Rajdhani and duranto	travel
Fulkanama express today from sec to vijaynagaram	travel
I need the fare of train  and flight	travel
Remind me on 11.10.2016 at 8.15 am to recharge idea data pack	recharge
all products have 60%????	shopping
What are the cheapest flights for the day	travel
Hi need a reservation at tamasha restaurant new delhi	food
hi manal, can you stop my water reminders	reminders
What is net balance inquiry number of aircel	recharge
I want to know nearby hotels	travel
Check ashtray in ebay	shopping
Bluetooth speakers	shopping
Xiomi service centre in varanasi	support
show me 22 October	travel
Cab booking?	travel
Conditioner	shopping
hi..i want to book tickets for a play at prithvi theatre..salaam 1950s k naam	movies
Reminder should be for enrollment	reminders
I did not set thr morninh alarm did i??	reminders
Can you tell me the available seats seats for podhigai exp..from chennai Egmore to sengotai..travelling date is 21/09/2016	travel
I want cab for tomorrow	travel
Hey where can i get john cena t shirts	shopping
I need hdfc atm	nearby
Already book my flight ticket with return	travel
Hiking shoes	shopping
Xiomi redmi note 3 grey black	shopping
Hey turn off reminders	reminders
Rajhans cinema navsari, gujara	movies
Mobile deals	shopping
Rent room for bachelors	travel
Hey, can you remind me about something?	reminders
can I get nearest SBI working ATM	nearby
Cash back offer	shopping
Flight to Chandigarh	travel
Delete all my reminders	reminders
i want long printed skirt wid slit	shopping
Make it 1 chicken biryani n pls cancel	food
I want to set another reminder	reminders
Hi I need to know what's the cheapest 28d/ monthly 3G plan across Vodafone, idea and Docomo networks	recharge
Micromax q345 covers	shopping
another bus stand tell me	travel
Plz set reminder morning	reminders
And wake up call number 8094946654	reminders
So say minutes pack of vodafone	recharge
Mechanic	travel
Need a call	reminders
Hotel booking	travel
Thanks for the drinking reminder I don't need you to remind me for that again	reminders
Remind me at 12:23 for my lunch	reminders
Wanna dinner	travel
Coorg	travel
AC 2 tier train details from Guwahati to Chennai before 23th of September	travel
Sorry I want earphones not headphones	shopping
Place to visit in Mumbai	travel
Flight cost from new Delhi to paro	travel
Can u give me movie timings?	movies
Hi, I am interested in Enticing Andaman 4 Nights 5 Days package. Please tell me more about it. {product_id:849, product_name:Enticing Andaman 4 Nights 5 Days, api_id:8, api_name:travel}{carousel_cta}	travel
Any exclusive offer for shoes?	shopping
Brother is the 10'0 clock bus A/C bus?	reminders
32gb rom 3gb ram	travel
Can u plz book my ticket to Diljeet show	travel
Is there a AC bus on 27th or 28th october in morning	travel
Show me about orian mall?	movies
Also can u check why boarding time is 2 hours prior.	travel
Food	food
Erode Trichy trains	travel
Want to buy some bra	shopping
Do u tell me about laser skin treatment?	shopping
Please suggest nearest bakeries which has cakes and provide home delivery	food
Find me nearest state bank of India	nearby
But there is no pvr or inox in my town	movies
Kindly deactivate DND on my phone	reminders
Call me Shraddha	reminders
Can u provide me company detail of skemi watches	shopping
Could u tell me the nearest axis bank branch	nearby
Pune to Jejuri...distance	travel
Delhi to Ambala Rail ticket for sleeper coch???	travel
Small panty pls	shopping
Plz check flight ceap rate from imphal to delhi on 21 oct	travel
Mungarumale 2  kannada film	movies
Show of some good brand	shopping
Roaming packs for aircel.	recharge
Cancel that 3.53 am	reminders
Dogs clothes	shopping
Cancel my wake up call at	reminders
Hey are trains available from Selem to Bangalore ??	travel
*go	travel
Any g shock watches ?	shopping
Can I get full slives t shirts	shopping
All variants of iphone7	shopping
Honda jazz on road price	travel
Hey,Can u get me packages of Singapore, Malaysia nd pataya?	travel
do i get any cash back on recharge	recharge
I want. Black forest cake	shopping
Please provide me the best price for i phone 5 s	shopping
Can you remove all the wake up calls.	reminders
Which movies are running now?	movies
Check fares on 26th October for flight	travel
Don't reminder	reminders
I dont want the reminder any more plz stop it	reminders
Lowest priced bean bags with bean	shopping
Hdfc atm	nearby
Best chinese restaurants near by	food
ETA mall	movies
Hiii Varnika can u tell fare of this train	travel
Is flight for tomorrow from guwahati to bangalore got cancelled?	travel
Subway in dlf mega mall ??	food
Hey can u find me the nearest petrol pump	nearby
I need ucb shorts	shopping
Kota  to jaipur.   Last train	travel
KFC	travel
Please find running status for train 12334	travel
Awake me at 8am	travel
OK now available in Sarawak from new Delhi to Chandigarh on 30th Dec and what will be the total fair in 1st AC for 4 ppl	travel
I want breakfast from mcdonalds	food
Papas Birthday reminder for tomorrow	reminders
I want to buy a samsung gear vr	shopping
Pls send me the menu for kanha	food
Udaipur	travel
Rates of flights for Delhi to Goa n vice versa	travel
I m looking to stay in goa for 25 sep to 30 sep	travel
Please  remind  me  of  exam on 25 September  5 pm	reminders
Hey pls find me a hotel near rajasthan bhavan tagarikanaka hyderabad	travel
Mi service center in ctc	support
I want  mobile charging original cord of Moto g3	shopping
Please send me every details of Redmi note 3 silver 32 gb.	shopping
Please set snoozer alarm also	reminders
Bank of India Atm	nearby
Please dont remind me about driniking water...i hvnt set tht reminder	reminders
Casual shoes	shopping
I want Nike or adidas or Puma women t-shirt	shopping
hey I want to set reminder	reminders
If any train in afternoon??	travel
Find adidas adispree shoes size 7	shopping
plan	travel
Hey, can you help me find an electrician?{task}	travel
Actually i want to plan a trip for my diwali vacation	travel
Please book same pnr Mumbai to Dubai	travel
show me deals on Leather bags	shopping
I want to cancel this reminder	reminders
nearest Mi Service Center	nearby
Cabs!!??	travel
Need help for pest control	travel
Laptop repair?	shopping
Tourist places near mongas hotel in Dalhousie	travel
Pizza mania veg	food
Coimbatore  bus	travel
Can you book the tickets	travel
running status of train no 14055	travel
Best deal for tenda single antenna router	shopping
Motorola G4 deals	shopping
I had asked for flight tickets reminders every 2 days	reminders
I want to go Vijayawada can u help me to travel	travel
Yes plz set drinking water reminder..after every 30 min frm rite nw itself..	reminders
Anything on jet airways flight ?	travel
Acham yenbathu madamaya da film release date ?	movies
My tp link router is not working can u help me in locating the nearest tp link service center	travel
How much does the Apple iPhone 6 extended warranty costs?	shopping
Hey there.  I bought a steam iron from snapdeal	shopping
I am looking for an accommodation in South Goa	travel
Telenor plans for 1miniute 25p	travel
Can u give me the list of movies which r released in recent time?	movies
Adidas flip flop	shopping
Help with Comedy visarjan 2 tickets please.	travel
Set alarm at 10:57 for tatkal ticket booking	travel
I was to order something from domino's	food
I want to order famzi ones	food
Pls remove my existing reminder of every 1 hour water	reminders
Find me the CCD cafes near me	nearby
I want to know about sleeper seats in Rishabh and Ashok travels	travel
When the time it will departure from nadikude	travel
I going to purchase Honda activa	shopping
Any good restaurant near by lalpur ranchi	food
And set me a reminder for tomorrow at 6.45 pm meeting with Dr. Nilesh talwadker at his clinic in panjim	reminders
Want subway	food
Can u plz find indian bank in andheri	nearby
Check in	travel
AC  or non AC couch	travel
I want to book a ticket from Diphu to chapormukh	travel
Wake me up	reminders
Checking menu	food
Ratlam to mumbai train	travel
Route please	travel
Can you order me a burger	food
Can u tell me location of airtel service centre from batla house	nearby
It must have stainless steel strap	shopping
Do I need internet to receive wake up call??	reminders
Hi, can you book a table for me at Grid restaurant kolkata	travel
I called up the hotel to check n the rooms r available	travel
Trip to andaman and nicobar for 7 days would cost how much?	travel
Find me nearby Lotus store	nearby
Is the icici bank open today?	nearby
Tell me distance between hunli to goa	travel
Tell me yrains from wardha to nagpur	travel
How much more tym will train 12033 take to reach new delhi station	travel
My flight is on October 27th	travel
Can you Suggest to me hotels in liluah, for 15 guests.	travel
I need to order fruits	food
Turn off water reminder	reminders
Wht is the lowest price of iphone 5s	shopping
Wake me up After half an hour to off the motor	reminders
Indian restaurants north indian food nearby?	food
Laundry: T-shirt-5 Shirt-4 1-boxer 1-shorts 2-hankies 1-socks 2-banyan 1-pant	shopping
Horror movie	movies
Want to pay postpaid voda...plz adv	recharge
Please help me find best headphones below Rs.700/-	shopping
Again check the full sleeve jersey of CRISTIANO	shopping
Remind me about saketh aadhaar card work tomorrow morning at 11	reminders
any tamil movie?	movies
What is the distance from Chennai Central Station to Kochi	travel
Which movie is best for watch..	shopping
Aquarium cleaning services	support
My wake up alarm is still not cancelled	reminders
Show me some yellow with pink lahenga	shopping
Where is the nearest hdfc bank	nearby
I have taken the flight	travel
Dominos ka sab sai sasta regular pizza kitne ka hai ?	food
Which movie is running in srinivasa theater ?	movies
Can you place an order from niteout for 1 awadhi kheer and 1 water bottle.. tell them to bring change	food
Samsung j3 pro price?	shopping
i want 2gb - 5gb in month	travel
Still I could not get refund of Airtel recharge remaining amount	recharge
Mujhe Vodafone postpaid ka call detail check karna hai kaise karu	recharge
Can you help me with Trains please	travel
Set reminder for today to call Anand and Friends for get together at sharp 7.00 pm today	reminders
Can u tell me ticket price of 3A	travel
Hey, can I get a list of restaurants around my area that deliver breakfast?	food
Cheapest flight from lucknow to delhi tomorrow	travel
Whether u I'll give any cash back offer	shopping
Remind me at 11 am to call gkwale to check on status of the photo	reminders
Please cancel this remainder I told u	reminders
Pl mention about the money... Not a general reminder	reminders
I need the best price for SF inverter tubular type battery 105 ah in chennai	shopping
i want music band watch with connected with bluetooth	shopping
Could you tell me the price of the 5:15 show at amanora?	shopping
Nyc lipstick from shoppers stop colour is cairns	reminders
Do you have any paytm offers on Vodafone bill payment?	recharge
Vodafone mai 4G start kab hoga??	travel
Laxmi studio	nearby
Can u pls book ticket for 12070	travel
near me sbi bank	nearby
Ripped jaggis for women	shopping
Remove wake up call	reminders
Nearby HTC care centre	nearby
Can you search polyurethane conveyor belt manufacturer in india	shopping
Orange tours and travels buses	travel
Do you have Flipcart and Amazon coupon code	shopping
Pick up portable charger	shopping
Its available from tenkasi to Chennai on Oct 31in bus..	travel
Pizza world	food
Any movie in English or hindi but with good reviews	movies
What are the criterias for cancelling my train ticket?	travel
yesterday u said there was a train to kasara from vikhroli station at 12:30 pm	travel
Track my flipkart order no FMPC0153551205	shopping
Any free premeir movie  tickets avalable	movies
Ny other cab apart frm ola?	travel
Can I get biryani non veg	food
jbl flip 3	shopping
I want to buy button cell	shopping
Lounge bar in kolkata	travel
last four trains	travel
Hello mam can you plz tel me nearby ASUS mobile service centre???	nearby
Can u recharge again	recharge
Find me 2 photo studios near sai veg world restaurant in Goregaon east	food
Find me a bus to airport	travel
Hey is there any royal cruser bus from haldwani(263139) to dehradun??	travel
What could be the best place to visit in December for honeymoon	travel
Tckt Rates?	travel
Call from u	reminders
U can book hotel only in india ?	travel
Give me the best flight fare Bangalore to Kolkata .. 16dec 2016	travel
Feeling hungry get me some restaurant	food
need mutton biryani papadams	food
And send me the list of shows on sunday	travel
I want running shoes	shopping
Near  Patangali store near tirlok puri	nearby
Departure time	travel
Hey.. I had asked for carpenter service. The carpenter came on Saturday saw what was suppose to be fixed and told me he would come on sunday morning to fix the problem	travel
Jio plans	travel
Reserve the booking of two seats	travel
Hi my teakwood chest has been slightly damaged. I need a carpenter/ woodworker to come home and have a look at it and see if it can be fixed. Would you be able to help with that? Thanks	travel
Remind me at 4.30 to go to gym	reminders
Pnb bank	nearby
Give details about iPhone 7	shopping
Motorola service center in Delhi??	support
Purchase men belt	shopping
Can u book me the tickets noe	travel
What are the travel packages	travel
Find me a train	travel
Do we have  deals on iPhone 6	shopping
Hey wanted to see some adidas shoes for men...could you plz help me with some options	shopping
bsnl 3g plan of 125	recharge
Due you have any coupon for dominos	food
Food delivery at this time possible?	food
Can you give me a holiday plan from 22nd December from Ranchi onwards till 2nd January preferred destination Srilanka,kerala back waters,cochin etc	travel
Any recent holidays	travel
Want to buy black formal belts	shopping
Ok can you tell the deal on Samsung A7 2016	shopping
I want to purchase moto e3 power	shopping
Cheaper power bank in good discount	shopping
Is RTC buses running today in Hyderabad??	travel
Vodafone m call rate km krne ke offers bta skte ho	recharge
i want to purchase bt i will purchase in new year	shopping
I want to buy Yepme Red Solid Quilted Jacket.{product_id:AD3398242FB7CF928BC7A00EF92C5892, product_name:Yepme Red Solid Quilted Jacket, api_id:1, api_name:shortlyst}{carousel_cta}	shopping
A haunting reminder	reminders
Tuesday 13 th from Hyderabad	travel
Want to travel rajkot on Friday evening near by 6pm so what should be best transportation way	travel
What are all the show timings for pink at seasons and amanora and nitesh hub?	movies
Hii could you please tell me the distance between Pune and Indore	travel
Check availability of seats for tomorrow show in the morning	travel
Call me to wake up	reminders
I would like uber	travel
call me	reminders
OK. Now pls tell me if I book the entire journey in one ticket what will be the fare & any concession on single ticket booking?	travel
Ok go ahead and book the appointment but will they be taking any visiting charges before starting the work ?	travel
I am going to banglore tomorrow and want a breakfast at anand bhavan tomorrow in the morning. Can u please send menu of the same restaurant???	travel
Iphone 7 pics & price	shopping
how to go VIZAG on 26th bus or train	travel
From Hyderabad to Manipal	travel
I want front cut kurti	shopping
Frm which restro?	food
Near by reliance shopping mall	nearby
Ya....Mumbai toh goa flight 26 March. ..	travel
Seat,Birth?	travel
Set alarm for morning 7 am	reminders
okhey .!  remind me every 2 hours	reminders
I have to set a new reminder can you do it ?	reminders
Live update of train no. 22405	travel
Any good Malayalam movie for 2nd  show in Chennai??	movies
Hi I am at Taj Bekal. I need a taxi drop to Mangalore airport on Monday morning at 10.30 am. Would need a sedan	travel
Please off my all reminders	reminders
status plz	travel
Yes amount is teken from my account	travel
Mi 5s	travel
Cancel all reminders	reminders
I need a review	shopping
call	reminders
I want to buy micro sd card reader on mobile through otg	shopping
I want a genuine travel company like chariot travels,travel air	travel
Dominos offers for today?	food
Cinepriya theatre	movies
Bay new pendrive sandisk 32 GB otg 3.0 offer	shopping
When will ai reach ahmedabad if I go through 4th January train	travel
Hey vikas i need a plumber	travel
Flight for delhi to allahabad	travel
Looking for warm color 60 watts LED 2700k temperatures bulbs	shopping
Please cancel all my alarms	reminders
Gyno doctor near ulubari	nearby
How much is the ticket for	travel
No reminders from now.	reminders
I need a 2TB or 1 TB HDD which is compatible with PS4.	shopping
Esteem mall having cinema	movies
Inform Jaipur to delhi flight for today	travel
Discount coupons on pizza delivery from dominos	food
Akira Friday 2 seats cinepolis first show pune	travel
Do u  give any food coupons?	food
reminders*	reminders
What movie is on at quest and cinepolis now after 9?	movies
Please help me with the web check in for the return flight	travel
Can i get iphone 7 images and features	shopping
Can you tell me , any Indian bank deposit  machine near to me	nearby
2 chicken Mexican taco (soft) and one cheesy fiesta potato	food
I need hdfc	nearby
Hi need to activate DND on my phone	reminders
Hi can you help me with any travel packages for maldives	travel
Restaurant nearby?	food
I want to buy hair straightener cream	shopping
Hi. Good evening. How can I booking train ticket via with you	travel
Which theater can u book my ticket	movies
Movies at Sangeeth theater in Salem	movies
Tell me train 12628 time shefule	travel
Can u tell me at time intercity express will reach at beawar ? Which goes from ahmedabad to ajmer ? With current running status	travel
Please cancel my daily reminder to cancel my company transport on weekends..it should be just for weekdays and I need only messages from you side would you please cancel the calling feature	reminders
Domino's  pizza mania offers  baby	food
Show please	shopping
hi can u help me in getting online dubai  tourist e visa  for two persons..travel dates 5 to 9 october	travel
Exotic goa	travel
"I want to buy 1.5"" and 2"" hose pipe"	travel
Lenovo mobile service center in jaipur..	support
Give me something on the Coolpad note 3 lite	shopping
Keep on calling again and again untill i answe the call	reminders
What is the distance between Kallakurichi and Pondicherry	travel
Sir, if i take a cab or ola/uber for the same distance? How much will i be charged.	travel
Want to buy shoes	shopping
Is Jungle Book movie running anywhere near my area?	movies
I want to buy a book	travel
Thanx for reminder me pls switch off the reminder	reminders
1bhk flat in kphb	nearby
Ercaud express train route	travel
I would like to know if any deals on Bluetooth headphones	shopping
Plz check raaz rebot show timings in opulent mall gzb	movies
Hi am interested in the 7 nights and 8 days package	travel
Nearest Dena Bank atm?	nearby
Which movie going on in bellary Radhika theatre	movies
Price of apple iPhone 5s 16gb on all ecommerce sites	shopping
Can u remind me about train status leaving from vasai road to diva jn	travel
show me some innergarments	shopping
Loafer	shopping
Tell me features of iPhone 7	shopping
Seat number ???	travel
M searching for an Allahabad bank atm in Prashant vihar	travel
From Mumbai to Kolkata	travel
Pune to jodhpur flight 31 oct return 4 nov 7 adults	travel
Can you check live status of trains	travel
can u book movie tickets in my location calicut	travel
Hi suman can you please check flight from Pune to Lucknow for 7th December	travel
Hey ..I want deals in men's wallet	shopping
where is nearby acer mobile service center	nearby
Which is best Burger King McDonald's	food
I want to buy a nice dress for my birthdat	shopping
I want a book..'when the shoe fits'	shopping
Which colours of socks and price	shopping
Can you check availability for rajdhani from Surat to Udaipur on 31st November	travel
My WiFi router Antenna is broken, can I repair from Vasco Da Gama	support
Please cancel my ticket	travel
Tel me Wt r all the movies running in Arrs at salem	movies
Best way to travel to Bangalore	travel
SBI ATM	travel
Sleeper pls	travel
Hi I need to install a projector @ dharuwera near gugaon. Can u get me a technician	travel
Can you please tell me the offers of dominos for today?	food
Can you please tell me the trains from tirupathi to Nellore after 3 o clock	travel
Could you make a reminder call for me	reminders
Prestige service center in Kanpur	support
Iphone 7 plz	shopping
Don't call to remind me	reminders
I am going to mumbai from pune 2 members please suggest best option to go	travel
Want dominoes deals of day	food
What are the movie timings and prices of tickets of pink at PVR Sion	movies
Tell me the movies screening in mumbai	travel
Restaurants nearby for  food delivery .please search nearby btm	food
Can you web check in for my flight?	travel
Tell me the best possible route to travel Greenland from Mumbai or Delhi	travel
Deals for power bank and pilot shots and nucleya shirts	shopping
What all colors?	shopping
Hey, can you give me movie show timings of south city moll?	movies
Ahmedabad to raipur air fare kya prise	travel
I need a seconand mobile with 3gb ram	shopping
Is the train 12275 delayed at the origin station	travel
Rajdhani or satabdi seat availability from jhansi to Vadodara	travel
show me some tshirts	shopping
Call again	reminders
Dhule adlabs manohar cinema	movies
Please can you tell me the name of the cinema irumugan runs which hall in chembur	movies
Hi can you find me SBI Bank branch in Okhla phase 1	nearby
I want apple 5 display	shopping
Current status of my train	travel
Lemon tree menu	food
Train ticket availiblity	travel
order south indian thalli	food
Shorts of medium size {task}	shopping
Remind me tomorrow at 11 morning for my pending task for interest reverasal calculation..hitesh sir signature..rbsa report follow up..bkc visit and andheri for vrl	reminders
I want a high power outdoor light	shopping
wish birthday	reminders
I want to buy earphone	shopping
I want to buy a single bed mattress	travel
Hi you tell me date of 16 September any  flight minimum price	travel
Note7	shopping
Ice cream	food
Explain 199 plan in airtel postpaid, tq	recharge
Hey is there any discounts for the flight tickets	travel
Lucknow charbaug station	travel
Plz cancel the alarm and schedule it for 5 pm...	reminders
Coaching classes for abacus	travel
Heels	shopping
I wanna smart phone under 5000rs	shopping
No I want a ticket for today	travel
Get me seat availability for tommorw Aandavan kattalai movie in amirtham theater madurai	movies
Can u help me find the nearest reliene store	nearby
I need study table	travel
Hi pooja	travel
Remind me a day before	reminders
Hey I want to reserve a table	food
I wanna jockey socks	shopping
Please activate DND on my phone	reminders
Is there any karnataka bank near to my location	nearby
Hie...I want some food on delivery at my place could you help	food
Hey can you remind me to submit my medical certificatw tomorrow	reminders
Menu of barbeque nation, sayaji hotel pune please	food
Can you please help me by sending my flight ticket on 30th September	travel
which socks	shopping
I want buy a pair of basketball shoes	shopping
where is dominos nearby	food
Joshny tell me one thing till what time I have to book tatkal ticket for tonight train	travel
I want to buy usb 3.0  16gb otg pendrive below 500	shopping
Wat abt irumugan review	movies
Chicken bonelesswith 4pieces	food
Some good restaurants in andheri	food
I want to buy Bingo U8 Smartwatch  (Black Strap){carousel_cta}	shopping
4 g data pack for idea	recharge
Cakes	food
What's the ticket fate	travel
Nearby chinese food	food
I'm seeking new action movies	movies
Hey bro I am absolutely searching about this iPhone 7 bro plz send me Iphone 7 price and photos	shopping
How to go to bhutan from guwahati Assam	travel
iPhone 7 launched ??	shopping
Can you give me best theme restaurant address and menu	food
Mumbai to Hyderabad	travel
Remind me to order masala dosa for my mother at 2 pm on saturday.	food
Which BEST bus number that go from andheri station west to z luxury residency hotel juhu tara....	travel
Off per ticket?	travel
https://www.google.co.in/url?sa=t&source=web&rct=j&url=http://www.amazon.in/Mens-Cotton-Sports-Track-Pant/dp/B00SZSUA2W&ved=0ahUKEwjKu6-y6-bOAhVKro8KHWjGDuMQFggmMAM&usg=AFQjCNF0RFYr-N9TpXDOwmmoRVAMIJlpow&sig2=pMGE5mDzaLmkJXenFnyh7g	shopping
I want to buy a mobile	shopping
Can you please try the web check-in	travel
I want axis Bank ATM	nearby
Any restaurant near by	food
50% on jabong?	shopping
Hi,  Can you tell me what will be the best season to visit sikkim,  rohtang pass??	travel
IPhone 5s price	shopping
live running status of kanyakumari bangalore express	travel
I want to know bus bookings from Hyderabad to nagpur on 28th october	travel
Watz d ticket price	travel
I want to book ticket thane to lonavala at the date of 24 September	travel
I want t shirt with my name.	shopping
Yap thanks.  ..fr the reminder.	reminders
Suggest me a good mobile	shopping
Hi Monik! Smart Wearables & Accessories are the hottest trend of 2016. I have handpicked the best ones under Rs.1499. Check them out now :)	shopping
New Kannada movies pls	movies
Samsung galaxy garden 2 battery	shopping
Want to purchase water dispenser	shopping
I need to go to agra cantt from tirur station on 6th of october any train availability?	travel
Yes. What are the confirmation chances of getting tatkal waiting list 21 ticket	travel
Can I get the tickets for kabbdi World Cup here ?	travel
Hotels in Saharanpur	travel
May i have some more options in puma sport shoes	shopping
Where to stay in Bangkok	travel
I wan bus from pune to akola(444001) at 8 pm	travel
Hi punit Can u reminder to my mom to take her tablet	reminders
Best smart phone under 5500rs	shopping
I'd like to order from Baskin Robbins	shopping
Hey which terminal do indigo flights to Kolkata take off from	travel
Or hongakong del	travel
Smart phone at rs1600	shopping
Train timing from Badnera to wardha	travel
I want bra	shopping
Courier service	nearby
Can u help me with train timings for tomorrow from ERODE to MYSORE at the early morning	travel
Planning to go to Spain	travel
Sir which is the best rate cutter plan for my dis no.	recharge
Vythiri resort kaha hai	travel
Nearest cng pump	nearby
Tel me mi service centre in thane west	travel
Golgumbz express timing plz	travel
Hello I want to book hotel in jaipur	travel
Dominos offer for today	food
Find a theatre in Guntur...	travel
Vijayawada	travel
This hotels are long show any near by hotels	travel
Any malayalam movies in goa	movies
Call me 7.30 am 2mrw	reminders
Please stop the reminder	reminders
Can u tell me abt any tata sky offers on recharge	recharge
I need to know nearest petrol station	nearby
I want to activate dnd on my 6s	reminders
Can you book me an ola share?	travel
Please set reminder for me for medicine1 again today and everyday at 10.00 am and 5 PM and 3 pm for medicine 2	reminders
i have micromax canvas colours 2 cell	shopping
Packages for Diwali holiday in a budget of 20000 per couple	travel
I didn't recieved a wake up call	reminders
call me twice, at a gap of 10 mins	reminders
32gb sd card	shopping
Hi I'm looking for home delivery of breakfast	food
movie ticket plz	movies
Can you tell me the shortest route to bhopal	travel
I want confirmed train ticket on 27 from secunderabad to howrah can you..?	travel
And Drink Water Reminder K Liye Call krna	reminders
Tour package for sikkim	travel
Today 10.30 am set remind for t.p.change..	reminders
How to stop particular reminder	reminders
I want to see the SBI ATM	shopping
Cheapest hotel in goa	travel
I want ticket of konark exp. From dadar to Pune on Tuesday 20 sep 2016	travel
Tally coaching centre	nearby
Get me food delivery options in DOMBIVALI east midc area	food
Near kdk college nagpur	travel
Can u send me link of golden color back cover	shopping
What is the price of 32 gb	shopping
Stop all the reminders  please	reminders
Can you check the flight prices for Singapore to Medan	travel
Where is the nearest syndicate bank?	nearby
Hookhabar near..	nearby
Which Hotel provides egg biryani nearby	food
may i know the train list guwahai to dibrugarh	travel
Offer for shoes of reebok or nike	shopping
Any SBI atm	travel
Hei can u hlp me. Today my bf come in bhubaneswar urgently .bt he cant reserved train or bus. .can u told me..haldia to bhubaneswar which train or bus are available today. .	travel
I ll drink rasam	food
Hey could you find me a nice pair of wireless headphones below 1500 rs	shopping
any coupons for indigo flight booking ??	travel
Near by escort service	nearby
Best price for flight ticket for delhi to Barnaul	travel
Can u help me with the travel packages	travel
Please cancel all my reminders	reminders
Hey .. take a reminder for tomorrow..	reminders
Activate dnd call	reminders
And can u also check for the return to mumbai on 18th of december?	travel
V3s mall	movies
Okay remind me every 30mins	reminders
Ram ram	travel
Can you give me full schedule of train no. 12472	travel
I want pizza	food
Nearest theatre	movies
I wanna book a flight	travel
Is there any bus service	support
Dental lab technician	travel
Plz cancel my reminders	reminders
Not a call	reminders
Is it possible to catch a 11am flight at Chandigarh  by starting at Palampur early in the morning	travel
Give me some best ear phones list	shopping
I want to purchase a microwave	shopping
128GB price?	shopping
I want to know train available   From sirdi to raipur	travel
When wl tatkal for AC open...10 am or 10:30	travel
Can you tell me nearby tiles store	nearby
I wanted to buy the monk who sold his ferrari	shopping
Redmi 3S (Dark Grey, 16 GB) is available on Flipkart for Rs. 6999.0.	shopping
Set the same reminder for 10am	reminders
I want skins for iphone 5s in Cash on delivery	shopping
Can you check seat availability for goa by Train for 14th October	travel
Hey can you show me le 2 cdla earphones	shopping
Don't set up any Appointment	reminders
Can you get me the details of bsnl 3g postpaid pack...	recharge
Review of suicide squad	movies
Call me  on at  9461154613!	reminders
Library near santacruz	nearby
which is the nearest italian restaurant iN bellandut	food
Any coupon for uber/ola	travel
new Delhi to kolkata by train 29sep	travel
There is any near stationary shop.	nearby
17416 train right now	travel
Hey, can you find me the nearest Apollo hospitals?	nearby
I want to buy maggi	food
Yes. 2 economy return tickets for Delhi-Chennai. Departure from Delhi early on 9th October and return late on 11th October.	travel
Please stop the reminder of drink water.. i got an habit of it. And thnks for making it fruitful	reminders
Check train tickets for Jabalpur to pune	travel
I want to check nearby Mens Parlour	travel
Another reminder please	reminders
Remind me to keep fast for navratre	reminders
You will send me the train ticket was available	travel
You didn't woke me up	reminders
Hi, I want to book tickets for PINK.{task}	movies
I need Innova from bangalore to trupti	travel
Whats the price of iphone 7 plus jet black colour 128 gb	shopping
Any discount available for ola rides?	travel
It is available on amazon	shopping
Can u assist me with some sports shoes?	shopping
The expected delivery date of an order in snapdeal was yesterday.but it was not delivered	shopping
Remind me to go for auditions on 25 September at 8 am	reminders
Train raipur to raigarg	travel
Can you please give me a reminder to go to the local shop	reminders
Remind me to collect the top on 29th September	reminders
I need slim fit in 40 long size I am to lean	shopping
Wana know town bus number to travel from thoraipakkam ptc busstop to Thiruvanmiyur	travel
Looking for a cheap and good hair trimmer. Can u plz suggest?	shopping
I want to book tickets for pink	movies
Bus stop koyambedu	reminders
Find me trains from LDH to Dalhousie	travel
Hi help me with the current flight status of flight number SV-5446 from Jeddah to Kolkata. This is a Saudi Haj flight.	travel
Remind me to call gifty	reminders
Bhaijaan	travel
From dominos	food
Ok good how to set reminders	reminders
Tamil mv in central pvr	travel
Remind me at 12	reminders
Where are seats	travel
Give me options of 5 star hotels in Lonavla	travel
1495 30gb airtel 3months recharge I can't find	recharge
Can u find mitorola service center in mumbai	travel
No i want cheapest mobile speakers	shopping
Shoes for girls within 600	shopping
When will Train number 16525 reach ottapalam?	travel
trichy to kanoor 13.9.16 .evanig 2class sleeper.	travel
Nearest pet shop where I can buy an aquarium	nearby
Low cost restaurants for north indian dishes	food
Tell me the coach position	travel
Leakage issue	travel
Seat availability for 12791 from Peddapalli station to Jabalpur boarding in Peddapalli on December 29 sleeper class and 3rd AC	travel
What are the morning show timmings for akira in cinepolis world trade park and first cinema	movies
Whats the price of iphone 6	shopping
Can you book tickets	travel
Details for i phone 7 with pricce	shopping
Do u guys help with the rescheduling of train ticket also	travel
Can u please check with the airlines the exact date ?	travel
Plz check is their any conform tickets available in guwahati exp	travel
White shoes for women	shopping
What r the cab services from kurukshetra to badrinath	travel
Kuppam to Mangalore trains	travel
I need to schedule some reminder	reminders
Movie time for pink in inox varun beach visakhapatnam	movies
Sex toys deals	shopping
Mumbai to shirdi total km	travel
Show me some option for plazzo	shopping
I need the most reasonable movers n packers for Mumbai to blore	travel
I want to book 3 tickets for the Rs. 150/- slot	travel
Zingy u have	travel
Can you find menthe cheapest flight ticket from delhi to imphal today	travel
Want a taxi	travel
Iphone 7 features ?	shopping
Apart from Toofan no other train available?	travel
Hi I want to watch parched	shopping
Need a cab from Mumbai to pune	travel
Full balance 9993920479	shopping
Plaining to go to Goa	travel
Would you tell me any train via Visakhapatnam	travel
Provide me the list of the resturant n hotels who dilever food at home	food
PNB bank ATM	nearby
I would like to cancel the reminder call pl	reminders
Dont call me for reminding	reminders
Deactivate my all reminders and alarm	reminders
Oh wat Abt Hand bags Below 600	shopping
We wish to travel to Mandvi Beach in Kutch, Gujarat on 30th Dec  to 1st Jan . The resort we have identified is Serena Beach Resort. Can you let us know the availability and the best deal in that Resort or give any other options of resort at Mandvi. We want 4 to 5 rooms. Can you help.	travel
Yup set it daniel	travel
I want cricket sports shoes	shopping
Is roaming free for reliance JIO sim inside India?	recharge
Hey can you find me Meizu service center nearby me	nearby
Mobiles?	shopping
Need a cab from delhi intl airport to chandigarh	travel
Could find  bsnl store near to me	nearby
Mac coffee	food
The reminder is that u have to go shop	reminders
Canon 5d camera price ???	shopping
I want to buy firstcopy burbery loafers	shopping
Any book stall near sollinganallure	travel
I phone 7 review	shopping
Movie theater	movies
Pic review please	movies
Remind me to call lalit..@5:45pm..I gave to Sought out the Matter with him	reminders
Give number if eagle patel and neeta travels	travel
Set remiinder to arrive home	travel
I want shoes	shopping
Pink movie sit availability pvr diamond plaza fr the 4:55 show today	movies
Place to visit in merrut	travel
Hey Hey want to plan a birthday lunch for my friends on  15th October Saturday for lunch... At khar Socials.. .  Can you let me know what offers or special packages they will be having  for lunch. There will be 40 ppl	travel
I want to go from delhi to mount Abu	travel
I need to plan a trip to north east for 5 days in December	travel
Is Hyderabad to Indore flight on time..?	travel
Promo codes for domino's pizza	food
iPhone 7 features	shopping
Full talktime BSNL Madhya Pradesh	travel
Laptops	shopping
I want to know the train from Howrah to Odisha	travel
Can you tell me about any goa packages??	travel
I will go to Vrindavan for a function on 6 and 7th November 2016, plan a proper trip for me. Please	travel
Give me prices for flight from delhi to dehradun on 29th of this month	travel
online wallet mobikwik or paytm offer for adding money	shopping
Dth ke recharge ke liya kya krna hoga	recharge
Reminder to check ios 10 update on 13 september	travel
Moto g4 plus 32 gb black	shopping
Nearest Punjab national bank office	nearby
Nearest icici bank atm?	nearby
Flat for rent	nearby
Could you tell me the Pune Mumbai flight timings for tomorrow afternoon post 2 PM	travel
Remind me by messaging me to drink water..do not call	reminders
What are the charges for home delivery for Kaju's pizza?	food
IS thiS information from Abhi buS.com????	travel
A simple dress for a teen girl	shopping
I want pair of formal shoes	shopping
Tell me the movies on cinemas	movies
I am having lenovo mobile with warranty	shopping
Hello can u help me with the train number 12935 coach position of D2	travel
iPhone 7 is available in the market???	shopping
No trains by 9:50	travel
I want to book a movie ticket	movies
dbs bank near me	nearby
Janta sahkari atm	travel
Nearby MICROMAX SERVICE CENTER	nearby
Where is Kanglei Fast food ?	food
Looking for best recharge options for data around 2-3 GB at best cheap price	shopping
Pl.send d timings of train from CST to PUNE after 02.45 pm onwards on today.	travel
Show me paragon canvas shoes	shopping
2 tickets for the month of November one way	travel
Gaya to jaipur seat availability 6nov 2016	travel
Plz tell me nearest theater to Gandhi Krishi Vigyan Kendra (GKVK) and which movie running on that theater	movies
what is the price of gionee p5l	shopping
Get me return train timungs from asr to ldh tommorow morning	travel
I want iphone 5s in silver colour	shopping
Buy now Samsung BHM1100NBEGINU	shopping
Xiaomi note 3 - 32 gb. Silver. Is it available on any website and at what cost?	shopping
Am looking  for 4 days package	travel
The flight I booked with you	travel
I want to fly to Goa...pl suggest me some flights..	travel
But what's my seat number	travel
Get me the status of my ticket	travel
Can i have nice decal for mac book pro under 200	travel
Any chicken dish for one?	food
What the cost of iPhone 7	shopping
Please cancel all my reminder calls	reminders
shoes	shopping
Please send train tatkal availability nagore to chennai date 27.9.2016 tomorrow	travel
Reliance store near royapuram	nearby
Can you tell me any reliable cab service which will ply between chanigah to manali and Dalhousie. I am travelling with family - so this has to be well rated	travel
I want to book railway ticket	travel
want to know flight and train availability n price for 30 September	travel
Hi how about an electrician , he never came	support
Train and car travelling with same speed say 80kmph, who cover more distance? Amd justify ur answer	travel
I wanna stop dis reminder	reminders
Check any ladies braslet cost of 200 with delivery service	shopping
Hey, needed to book a cab for 3.45am today..	travel
Looking for biryani	food
We have no announcements for boarding of that flight	travel
Can u pl tell me hotel Goa's pearl address, Candolim..	travel
Show me show timings of kstar movie a vasai	movies
Can I have Yatra.com international flight customer care no	travel
Movies thus Friday?	movies
i ball care service centre	support
Samsung j series ?	shopping
Hi am looking to buy a good smartphone up to 25k can u help me with it	shopping
Hi, can you pls tell me....is there any direct flight from jaipur to indore	travel
Stop these reminders	reminders
I want to buy a dumbels	shopping
Nearest Metro Station to ojas Institute of mamagement	travel
Charges of one cheetza is KFC with taxes?	travel
7 tickets from hyderabad to kottayam train	travel
Any buy one get one free in pizza?	food
Please tell me tickets of shatabdi	travel
I want to cancel a circular train ticket of tomorrow	travel
Give me all the colour models of pulsar 150	shopping
Need food order	food
Plz find icici bank my near location	nearby
Trains from Bangalore to Mumbai kalyan	travel
Plz give the shedule of train for rourkela to sambalpur	travel
Sir kurta pazama	shopping
Hi. I'd like to buy a pair of grey boots. Could you give me some suggestions?	shopping
Train from kalyan to chinchwad	travel
Want to go from Dhenkanal to Bangalore on 7th October and from there to go to Shirdi and back to Dhenkanal, Odisha on 12th. Plan a trip both by plane and train and let me know.	travel
Sbi??	travel
Union banks atm	nearby
mandor express me maalgaadi wala coach h kya ?	travel
Metro Station?	travel
branded bluetooth headphones under 500	shopping
I need a travel package to Kashmir, with itinerary and price.	travel
Find me buses from bhopal to indore on 13 sep 2016 it should be a non ac bus	travel
Need to book a car for one day in Mumbai	travel
Looking for apple store	shopping
kisi aur train me dekhe	travel
Splender pro price ?	shopping
Shopping	shopping
I got a message to recharge for 195 and get 1gb net but now when m trying to do its not happening	reminders
Kota to niimch train	travel
Shower gel	travel
Vanisha help to find HDFC ATM nearby my location .	nearby
Tell me the details of rameshwaram express who is departure from jaipur to chennai...	travel
When will thodari release?	movies
Show me the flight tickets to Andaman during 19th december,2016	travel
Where is nearby pizza hut??	food
Rishikesh bike trip	travel
Ok book gold colour	shopping
Information abt hotels	travel
I want to stay in lodge	travel
I want to buy  online book	travel
1 ac train hai	travel
Can u contact the Dealer of royal Enfield for can changing the colour of classic 350	shopping
You try in below train	travel
KTK Bank	nearby
Bank of Maharashtra bank atm	nearby
Cancel the call reminder to neena jee	reminders
Can u tell me the width of this product	shopping
yes. got my pizza	food
Near by gym	nearby
Tell Tell me seats available in VRL today nite VRL bus karatagi to bangalore today nite ad coast	travel
I want to buy Red Tape Loafers this Sunday, any suggestions	shopping
Could you filter these by brand. Jack and jones	shopping
Is there an availability in pushpak train for 22 Dec 2 tier ac	travel
Threre no option in my settings to change reminder call to notification	reminders
I need the live status of the train puneet	travel
Why didn't I get my reminder to wake up today	reminders
Well I need to travel from Siwan to Delhi..if you could assist me with the same	travel
Movie review of dharmadurai	movies
Free recharge coupons?	recharge
Have you remind Rigveda restaurant about my order	food
I'm using Vodafone prepaid	recharge
Plz find me tickets from kochi to delhi on 11th October and back to kochi on 13th	travel
Is there barbecue nation outlet near phoenix market city mall at kurla	food
Yeah I want to travel by flight from Chennai to Kolkata on 14 th October	travel
Please change the time	travel
Hey vaidehi can u plz check hrtc buses availablr from delhi isbt kashmiri gate to hamirpur	travel
Bus ticket to karnal	travel
Seat is available on 19/sept 2016 12619-train no	travel
I wnt to buy mobile	shopping
Hi hello I want fish land restaurant in Ameerpet route	travel
Non veg restaurant	food
Hey, pls book two tickets in the 9.30pm bus	travel
